0,0,0,0,2,2,0,0,0,0,0,0,0,2,2,2,0,0,0,0
0,0,0,2,2,2,2,2,0,0,0,2,2,2,2,2,0,0,0,0
0,3,0,2,2,0,0,0,0,0,0,0,2,2,2,0,0,0,0,0
0,6,3,4,4,5,0,0,3,4,4,5,0,0,0,0,0,2,2,2
0,9,6,7,7,8,2,2,6,7,7,8,0,0,0,2,2,2,2,0
0,0,6,7,7,8,2,0,6,7,10,11,0,0,2,2,2,0,0,0
0,0,6,7,7,8,0,0,6,7,3,4,5,0,2,2,3,5,0,0
0,2,9,10,10,11,0,0,9,10,6,7,8,0,0,0,9,3,5,0
2,2,2,0,0,0,0,0,0,0,9,10,11,0,0,0,0,9,11,0
0,2,0,0,2,2,2,0,0,0,0,0,2,0,0,0,0,0,2,2
0,0,0,0,2,2,0,0,0,0,2,2,2,0,0,0,2,1,2,0
0,0,0,0,0,0,0,0,0,2,2,2,0,0,1,2,2,2,0,0
0,2,2,2,2,0,0,0,2,2,2,0,0,1,0,2,2,0,0,0
2,2,2,2,0,0,0,0,0,0,0,0,0,0,0,1,1,0,0,0
0,2,2,2,0,0,0,0,0,0,0,0,0,0,0,0,0,0,0,0
